[[0 5 4 5 0 0]
 [0 5 4 4 5 0]
 [0 0 6 4 5 0]
 [0 0 5 4 6 0]
 [0 0 5 4 3 6]
 [0 0 0 6 3 2]]